##########
#........#
#.###.##.#
#.#S.....#
#.###.##.#
#.#...##.#
#..##...##
##.####.##
#...E#..##
##########
